1 1 1 1 1 1 1 1 1 1 1
1 9 0 0 6 1 6 0 3 0 1
1 0 1 1 0 1 0 1 1 0 1
1 0 0 0 0 0 0 0 0 5 1
1 1 1 1 0 1 0 1 1 1 1
1 5 0 0 0 0 0 0 0 5 1
1 0 1 1 0 0 0 1 1 0 1
1 0 0 0 0 1 0 0 0 0 1
1 2 0 0 0 1 0 0 9 0 1
1 1 1 1 1 1 1 1 1 1 1